正文输出指导:
  基本要求:
    剧情连贯: 延续之前的剧情，流畅且合理过渡到{{user}}来到男弟子房休息的情境
    格式要求: 正文作为LLM输出的一部分，包裹在xml标签<MAIN_TEXT></MAIN_TEXT>内部。
    事件概述: {{user}}在本轮的互动中选择在男弟子房休息
    输出人称: 第二人称"你"
    参考元素:
      - 时间: 根据具体的年、月、周的信息，合理设计当前输出剧情的季节、天气、晨昏等时间背景
      - 地点: 对男弟子房的环境进行描写
      - 在场NPC: 根据提供的在场NPC信息，将他们自然融入剧情，此外，鼓励自由发挥，根据剧情需要合理引入其他路人NPC比如"普通路人A"、"外门弟子B"、"天山派门客C"等
      - 休息过程: 具体描写{{user}}打坐调息、整理床铺、小憩片刻、与室友闲聊等休息过程
  选择结果:
    概述: 事件的结果不一定都是正向的，有可能成功也有可能失败，实事求是根据选择结果(大成功、成功、一般、失败、大失败，一共五种可能的结果)，合理流畅地编排剧情发展
    各结果可能的剧情发展倾向:
      - 大成功: 精神焕发/心境提升/获得灵感/意外收获/etc
      - 成功: 恢复良好/心情愉悦/得到休息/增进友谊/etc
      - 一般: 按部就班/平淡休息/略有恢复/etc
      - 失败: 难以入静/被人打扰/休息不佳/心烦意乱/etc
      - 大失败: 噩梦惊醒/与人冲突/物品被盗/etc
  剧情结构:
    概述: 输出一个包含起承转合的完整的事件，类似一个单元剧形式，有始有终，不留下悬念
    各剧情结构介绍:
      - 起: 顺延之前的剧情完成转场，并引入休息动机
      - 承: 描述休息过程，展现放松与调整
      - 转: 出现转折点（休息的效果或意外情况）
      - 合: 总结休息成果，自然收尾
  注意事项:
    - 成败都要合理，不过分夸大
    - NPC反应符合性格设定
    - 保持武侠氛围的真实感